FratQuest
An Interactive Fiction by Robert Giusti and Ryan Anderson
Release 1 / Serial number 130317 / Inform 7 build 6G60 (I6/v6.32 lib 6/12N) SD

Porch
You arrive at the Fraternity House. Your friend Chad, from High School invited you to a party here tonight. You've been putting off his invitations for almost all four years that you both have been in college, including all of freshman year when you two were roommates. But now, you're finally here, and even Your Girlfriend, Stacy is supposed to be here tonight. Sure the two of you have been pretty distant lately, but tonight just might be your chance to fix things between you, or end them for good. Might as well give it the old college try, eh?

You are outside of the fraternity house. On the side of the building are large, red metal letters, spelling out BRO.

Two large, swinging doors block the path into the house.

The biggest frat guy you've ever seen blocks your way into the party. The bouncer stands there, looking intimidating. You should try telling him about Chad in order to get into the party.

>North
Entrance Hall
People are scattered about in conversation, drinking beer. You can see pledges rushing to and fro, balancing cups of beer and packed bongs. There are doors to the EAST and WEST, as well as stairs to the NORTH. The exit back to the patio is SOUTH.

* * *

>sober
That's not a verb I recognise.

* * *

>drink
What do you want to drink?

* * *

>showme
Porch - room
    yourself - person
        beer

* * *

>drink beer
You chug the drink, and feel a little bit drunker.

* * *

>sobriety test
(the beer)
Inanimated objects can't be as drunk as you can be.

>sobriety test self
You think you've had about 0 drinks tonight.

>drink beer
You chug the drink, and feel a little bit drunker.

>sobriety test self
You think you've had about 1 drinks tonight.

>drink beer
You chug the drink, and feel a little bit drunker.

>sobriety test self
You think you've had about 2 drinks tonight.

>drink beer
You chug the drink, and feel a little bit drunker.

>sobriety test self
You think you've had about 3 drinks tonight.

>drink beer
You chug the drink, and feel a little bit drunker.

>sobriety test self
You think you've had about 4 drinks tonight.

>sobriety test self
You think you've had about 4 drinks tonight.

>drink beer
You chug the drink, and feel a little bit drunker.

>sobriety test self
You think you've had about 7 drinks tonight.

* * *

>north
(first opening the House Door)
It seems to be locked.

You dodge to avoid a muscular loud wannabe frat guy as they charge past.

>west
Living Room
A living room that has been converted to a dance floor. People are packed into the room, dancing close to each other. The music booms, and you can hear nothing else. There are doors to the EAST and NORTH.

* * *

>north
(first opening the House Door)
It seems to be locked.

You dodge to avoid a muscular loud wannabe frat guy as they charge past.

>east
Kitchen
A Kitchen. There are several fridges, an oven range, as well as a table. On the table, there are full cups of beer. A pair of pledges pours beers from a keg and places them onto the table, keeping it refreshed. To the SOUTH, there is a long line outside of the bathroom. There are also doors to the NORTH and WEST.

* * *

>north
(first opening the House Door)
It seems to be locked.

You dodge to avoid a muscular loud wannabe frat guy as they charge past.

>north
Upstairs Hallway
A long hallway, in several parts. You can explore more of the hallway by going EAST and WEST. To the SOUTH are the stairs back to the Entrance Hall. In this part of the Hallway, there is a door with a tie wrapped around it to the NORTH.

Some dude sits surrounded by drunk girls playing a "totally original" acoustic cover of "Fireflies" by Owl City on his guitar. They are eating this shit up. You hate that song...

>west
West Hallway
The west part of the hallway. This is the filthiest part of the house, and where the pledges are forced to live. The pledge dorm is to the WEST, there's a bathroom to the NORTH, and a door to an unmarked room to the SOUTH.

>south
You are about to enter when you are hit by some sort of ungodly stench, oh god, its like a million pieces of old broccoli stuff inside a dead whale. Fuck that noise, no way are you going in there.

>south
You are about to enter when you are hit by some sort of ungodly stench, oh god, its like morning after jager shits and tofu. Fuck that noise, no way are you going in there.

>south
You are about to enter when you are hit by some sort of ungodly stench, oh god, its like a million pieces of old broccoli stuff inside a dead whale. Fuck that noise, no way are you going in there.

>south
You are about to enter when you are hit by some sort of ungodly stench, oh god, its like dick sweat and cheetos. Fuck that noise, no way are you going in there.

>south
You are about to enter when you are hit by some sort of ungodly stench, oh god, its like dick sweat and cheetos. Fuck that noise, no way are you going in there.

>south
You are about to enter when you are hit by some sort of ungodly stench, oh god, its like puke, like, way too much puke, but on fire. Fuck that noise, no way are you going in there.

>south
You are about to enter when you are hit by some sort of ungodly stench, oh god, its like dick sweat and cheetos. Fuck that noise, no way are you going in there.

>south
You are about to enter when you are hit by some sort of ungodly stench, oh god, its like pubes that have been struck by lightning. Fuck that noise, no way are you going in there.

>south
You are about to enter when you are hit by some sort of ungodly stench, oh god, its like dick sweat and cheetos. Fuck that noise, no way are you going in there.

>south
You are about to enter when you are hit by some sort of ungodly stench, oh god, its like that one plant that smells like dead people had sex with a skunk, Hulk Hogans scrotum, a sickly tomcat with eight teeth, and an anchovie, and the dna result from the paternity suit showed that they were all collectively the sticky ass father. Fuck that noise, no way are you going in there.

>south
You are about to enter when you are hit by some sort of ungodly stench, oh god, its like dick sweat and cheetos. Fuck that noise, no way are you going in there.

>east
Upstairs Hallway
A long hallway, in several parts. You can explore more of the hallway by going EAST and WEST. To the SOUTH are the stairs back to the Entrance Hall. In this part of the Hallway, there is a door with a tie wrapped around it to the NORTH.

Some dude sits surrounded by drunk girls playing a "totally original" acoustic cover of "Rolling in the Deep" by Adele on his guitar. They are eating this shit up. You hate that song...

>east
East Hallway
The east part of the hallway. This corner of the house takes the longest for cops to reach when parties get rolled, and as such is home to much of the drug consumption in the house. There is a bathroom to the SOUTH, a room that reeks of pot to the NORTH, and a beautiful mahogany door to the EAST.

>north
Stoner Den
A dark room. Your vision is obscured by smoke, which clouds the room and fills your lungs. The only light you can use to make your way through the room is the laser-light show projected on the ceiling, captivating the inhabitants of the room. The exit is to the SOUTH.

You can see four Stoners here.

>ask stoner about life
The stoner stares blankly at you, "I'm sorry, totally zoned during what you just said." This won't go anywhere fast...

>sobriety test stoner
You can tell from their eyes and the bag of funions they are opening that they are definitely not sober.

>sobriety test stoner
You can tell from their eyes and the bag of funions they are scarfing down that they are definitely not sober.

>sobriety test stoner
You can tell from their eyes and the bag of funions they are still munching on, that they are definitely not sober.

>sobriety test stoner
You can tell from their eyes and the bag of funions they are still munching on, that they are definitely not sober.

* * *

>north
(first opening the House Door)
It seems to be locked.

You dodge to avoid a muscular loud wannabe frat guy as they charge past.

>tell bouncer about chad
The bouncer looks down at his clipboard, then nods at you and opens the door up. You're free to enter the party!

>enter
[You must supply a noun.]

>go inside
You can't go that way.

[The only way to go is north.]

>go north
Entrance Hall
People are scattered about in conversation, drinking beer. You can see pledges rushing to and fro, balancing cups of beer and packed bongs. There are doors to the EAST and WEST, as well as stairs to the NORTH. The exit back to the patio is SOUTH.

Some girl that you've had classes with (I think her name is Claire?) is hanging out, nursing a beer, in the corner of the room.

Some girl that you've had classes with (I think her name is Claire?) walks up to you. You notice her sweatshirt with the greek letters "Sigma Iota Sigma"

"Oh my god, hi!" she squeeks. You look at her somewhat puzzled, until she responds, "It's me, Claire! We've had like, five classes together? Don't you remember me from that Film class where we only watched really boring black-and-white movies? Well I've noticed you!" You get a little bit of a creepy vibe from her...

>go east
Kitchen
A Kitchen. There are several fridges, an oven range, as well as a table. On the table, there are full cups of beer. A pair of pledges pours beers from a keg and places them onto the table, keeping it refreshed. To the SOUTH, there is a long line outside of the bathroom. There are also doors to the NORTH and WEST. Line length: 5.

You keep seeing pledges wearing diapers, wonder what that's all about...

Tucker from one of your GEs freshman year is posted up next to the kegs, downing beer after beer.

You can also see a Bathroom Door here.

Claire arrives from the west.

Claire tries to touch your hand.

>go north
Dining Room
A dining room that has been converted to a sort of Beer Pong Arena. Teams are playing the game at four different tables, which take up the majority of the room. There is an air of intensity from how seriously the players are taking their game. There are doors to the SOUTH and WEST.

A pledge scurries past you, carrying a beer for someone more important.

Chad, from High School is here. He looks really disappointed. He seems to be waiting for someone.

Pledge departs.

Claire arrives from the south.

Claire moves a litle bit in front of you to insure that she's in your field of vision, and stares intently at you.

>go south
Kitchen
A Kitchen. There are several fridges, an oven range, as well as a table. On the table, there are full cups of beer. A pair of pledges pours beers from a keg and places them onto the table, keeping it refreshed. To the SOUTH, there is a long line outside of the bathroom. There are also doors to the NORTH and WEST. Line length: 9.

You keep seeing pledges wearing diapers, wonder what that's all about...

Tucker from one of your GEs freshman year is posted up next to the kegs, downing beer after beer.

You can also see a Bathroom Door here.

Pledge departs.

Claire arrives from the north.

Claire readjusts her sweatshirt in order to make you notice her more.

>go east
You can't go that way.

[From here, you can go north, south and west.]

Claire readjusts her sweatshirt in order to make you notice her more.