FratQuest
An Interactive Fiction by Robert Giusti and Ryan Anderson
Release 1 / Serial number 130303 / Inform 7 build 6G60 (I6/v6.32 lib 6/12N) SD

Porch
You are outside of the fraternity house. Two large, swinging doors block the path into the house. On the side of the building are large, red metal letters, spelling out BRO. A door leading inside is to the NORTH.

>North
Entrance Hall
People are scattered about in conversation, drinking beer. You can see pledges rushing to and fro, balancing cups of beer and packed bongs. There are doors to the EAST and WEST, as well as stairs to the NORTH. The exit back to the patio is SOUTH.

* * *

FratQuest
An Interactive Fiction by Robert Giusti and Ryan Anderson
Release 1 / Serial number 130303 / Inform 7 build 6G60 (I6/v6.32 lib 6/12N) SD

Porch
You are outside of the fraternity house. Two large, swinging doors block the path into the house. On the side of the building are large, red metal letters, spelling out BRO. A door leading inside is to the NORTH.

>sober
That's not a verb I recognise.

* * *

FratQuest
An Interactive Fiction by Robert Giusti and Ryan Anderson
Release 1 / Serial number 130303 / Inform 7 build 6G60 (I6/v6.32 lib 6/12N) SD

Porch
You are outside of the fraternity house. Two large, swinging doors block the path into the house. On the side of the building are large, red metal letters, spelling out BRO. A door leading inside is to the NORTH.

>drink
What do you want to drink?

* * *

FratQuest
An Interactive Fiction by Robert Giusti and Ryan Anderson
Release 1 / Serial number 130303 / Inform 7 build 6G60 (I6/v6.32 lib 6/12N) SD

Porch
You are outside of the fraternity house. Two large, swinging doors block the path into the house. On the side of the building are large, red metal letters, spelling out BRO. A door leading inside is to the NORTH.

>showme
Porch - room
    yourself - person
        beer

>drink beer
*** Run-time problem P10: Since the beer is not allowed the property "alcohol content", it is against the rules to try to use it.

* * *

FratQuest
An Interactive Fiction by Robert Giusti and Ryan Anderson
Release 1 / Serial number 130303 / Inform 7 build 6G60 (I6/v6.32 lib 6/12N) SD

Porch
You are outside of the fraternity house. Two large, swinging doors block the path into the house. On the side of the building are large, red metal letters, spelling out BRO. A door leading inside is to the NORTH.

>drink beer
You chug the drink, and feel a little bit drunker.

* * *

FratQuest
An Interactive Fiction by Robert Giusti and Ryan Anderson
Release 1 / Serial number 130303 / Inform 7 build 6G60 (I6/v6.32 lib 6/12N) SD

Porch
You are outside of the fraternity house. Two large, swinging doors block the path into the house. On the side of the building are large, red metal letters, spelling out BRO. A door leading inside is to the NORTH.

>sobriety test
(the beer)
Inanimated objects can't be as drunk as you can.

Whoa, you can't just do that to anybody!

>sobriety test self
You think you've had about 0 drinks tonight.

* * *

FratQuest
An Interactive Fiction by Robert Giusti and Ryan Anderson
Release 1 / Serial number 130303 / Inform 7 build 6G60 (I6/v6.32 lib 6/12N) SD

Porch
You are outside of the fraternity house. Two large, swinging doors block the path into the house. On the side of the building are large, red metal letters, spelling out BRO. A door leading inside is to the NORTH.

>north
Entrance Hall
People are scattered about in conversation, drinking beer. You can see pledges rushing to and fro, balancing cups of beer and packed bongs. There are doors to the EAST and WEST, as well as stairs to the NORTH. The exit back to the patio is SOUTH.

>west
Living Room
A living room that has been converted to a dance floor. People are packed into the room, dancing close to each other. The music booms, and you can hear nothing else. There are doors to the EAST and NORTH.

>north
Patio
An open-aired social area with many chairs and tables. People are sitting about, smoking cigarettes. You see a pledge with a sign around his neck that says, "Pack of Smokes: $5". Stairs down into the main area of the backyard are to the NORTH. There are doors to the EAST and SOUTH.

>east
Dining Room
A dining room that has been converted to a sort of beer pong arena. Teams are playing the game at four different tables, which take up the majority of the room. There is an air of intensity from how seriously the players are taking their game. There are doors to the SOUTH and WEST.

>south
Kitchen
A Kitchen. There are several fridges, an oven range, as well as a table. On the table, there are full cups of beer. A pair of pledges pours beers from a keg and places them onto the table, keeping it refreshed. To the SOUTH, there is a long line outside of the bathroom. There are also doors to the NORTH and WEST.

>south
Downstairs Bathroom
A dirty bathroom. The toilet is broken, and you can see a swirl of brown and yellow colors in the water. The floor is sticky. There is a used condom on the ground. The door back to the kitchen is NORTH.

>north
Kitchen
A Kitchen. There are several fridges, an oven range, as well as a table. On the table, there are full cups of beer. A pair of pledges pours beers from a keg and places them onto the table, keeping it refreshed. To the SOUTH, there is a long line outside of the bathroom. There are also doors to the NORTH and WEST.

>west
Entrance Hall
People are scattered about in conversation, drinking beer. You can see pledges rushing to and fro, balancing cups of beer and packed bongs. There are doors to the EAST and WEST, as well as stairs to the NORTH. The exit back to the patio is SOUTH.

>drink beer
You chug the drink, and feel a little bit drunker.

>drink beer
You chug the drink, and feel a little bit drunker.

* * *

>north
Entrance Hall
People are scattered about in conversation, drinking beer. You can see pledges rushing to and fro, balancing cups of beer and packed bongs. There are doors to the EAST and WEST, as well as stairs to the NORTH. The exit back to the patio is SOUTH.

>east
Kitchen
A Kitchen. There are several fridges, an oven range, as well as a table. On the table, there are full cups of beer. A pair of pledges pours beers from a keg and places them onto the table, keeping it refreshed. To the SOUTH, there is a long line outside of the bathroom. There are also doors to the NORTH and WEST.

>north
Dining Room
A dining room that has been converted to a sort of beer pong arena. Teams are playing the game at four different tables, which take up the majority of the room. There is an air of intensity from how seriously the players are taking their game. There are doors to the SOUTH and WEST.

>west
Patio
An open-aired social area with many chairs and tables. People are sitting about, smoking cigarettes. You see a pledge with a sign around his neck that says, "Pack of Smokes: $5". Stairs down into the main area of the backyard are to the NORTH. There are doors to the EAST and SOUTH.

>drink beer
You chug the drink, and feel a little bit drunker.

>test sobriety self
I only understood you as far as wanting to test that.

>test sobriety self
I only understood you as far as wanting to test that.

>sobriety test self
You think you've had about 5 drinks tonight.

>sobriety test
(the beer)
Inanimated objects can't be as drunk as you can.

Whoa, you can't just do that to anybody!

>drink beer
You chug the drink, and feel a little bit drunker.

I beg your pardon?

I beg your pardon?

>sobriety test self
You think you've had about 19 drinks tonight.

* * *

FratQuest
An Interactive Fiction by Robert Giusti and Ryan Anderson
Release 1 / Serial number 130303 / Inform 7 build 6G60 (I6/v6.32 lib 6/12N) SD

Porch
You are outside of the fraternity house. Two large, swinging doors block the path into the house. On the side of the building are large, red metal letters, spelling out BRO. A door leading inside is to the NORTH.

>go inside
You can't go that way.

>go north
Entrance Hall
People are scattered about in conversation, drinking beer. You can see pledges rushing to and fro, balancing cups of beer and packed bongs. There are doors to the EAST and WEST, as well as stairs to the NORTH. The exit back to the patio is SOUTH.

* * *

FratQuest
An Interactive Fiction by Robert Giusti and Ryan Anderson
Release 1 / Serial number 130303 / Inform 7 build 6G60 (I6/v6.32 lib 6/12N) SD

Porch
You are outside of the fraternity house. Two large, swinging doors block the path into the house. On the side of the building are large, red metal letters, spelling out BRO. A door leading inside is to the NORTH.

>go north
Entrance Hall
People are scattered about in conversation, drinking beer. You can see pledges rushing to and fro, balancing cups of beer and packed bongs. There are doors to the EAST and WEST, as well as stairs to the NORTH. The exit back to the porch is SOUTH.

>go north
Central Hallway
A long hallway, in several parts. You can explore more of the hallway by going EAST and WEST. To the SOUTH are the stairs back to the Entrance Hall. In this part of the Hallway, there is a door to the NORTH.

>go north
Designated Hookup Room

>go south
Central Hallway
A long hallway, in several parts. You can explore more of the hallway by going EAST and WEST. To the SOUTH are the stairs back to the Entrance Hall. In this part of the Hallway, there is a door to the NORTH.

>go east
East Hallway
The east part of the hallway. There are doors to the NORTH, EAST, and SOUTH.

>go north
Stoner Den
A dark room. Your vision is obscured by smoke, which clouds the room and fills your lungs. The only light you can use to make your way through the room is the laser-light show projected on the ceiling, captivating the inhabitants of the room. The exit is to the SOUTH.

You can see three Stoners here.

>test stoner mood
I only understood you as far as wanting to test that.

>ask stoner about weed
There is no reply.

* * *

>go north
Central Hallway
A long hallway, in several parts. You can explore more of the hallway by going EAST and WEST. To the SOUTH are the stairs back to the Entrance Hall. In this part of the Hallway, there is a door to the NORTH.

>go south
Entrance Hall
People are scattered about in conversation, drinking beer. You can see pledges rushing to and fro, balancing cups of beer and packed bongs. There are doors to the EAST and WEST, as well as stairs to the NORTH. The exit back to the porch is SOUTH.

>go west
Living Room
A living room that has been converted to a dance floor. People are packed into the room, dancing close to each other. The music booms, and you can hear nothing else. There are doors to the EAST and NORTH.

>go north
Patio
An open-aired social area with many chairs and tables. People are sitting about, smoking cigarettes. You see a pledge with a sign around his neck that says, "Pack of Smokes: $5". Stairs down into the main area of the backyard are to the NORTH. There are doors to the EAST and SOUTH.

You can see Cigarette Bitch here.

>ask bitch about smokes
He's a pledge, what's he gonna know?

>ask bitch about pack of smokes
This Pledge is not happy about being Cigarette Bitch tonight, he scowls at you, "Cigarette's are 5 bucks." Better find some money or help this guy lighten up.

* * *

>go north
Entrance Hall
People are scattered about in conversation, drinking beer. You can see pledges rushing to and fro, balancing cups of beer and packed bongs. There are doors to the EAST and WEST, as well as stairs to the NORTH. The exit back to the porch is SOUTH.

>go south
Porch
You are outside of the fraternity house. Two large, swinging doors block the path into the house. On the side of the building are large, red metal letters, spelling out BRO. A door leading inside is to the NORTH.

* * *

>go north
Entrance Hall
People are scattered about in conversation, drinking beer. You can see pledges rushing to and fro, balancing cups of beer and packed bongs. There are doors to the EAST and WEST, as well as stairs to the NORTH. The exit back to the porch is SOUTH.

>go east
Kitchen
A Kitchen. There are several fridges, an oven range, as well as a table. On the table, there are full cups of beer. A pair of pledges pours beers from a keg and places them onto the table, keeping it refreshed. To the SOUTH, there is a long line outside of the bathroom. There are also doors to the NORTH and WEST.

>go north
Dining Room
A dining room that has been converted to a sort of beer pong arena. Teams are playing the game at four different tables, which take up the majority of the room. There is an air of intensity from how seriously the players are taking their game. There are doors to the SOUTH and WEST.

>go south
Kitchen
A Kitchen. There are several fridges, an oven range, as well as a table. On the table, there are full cups of beer. A pair of pledges pours beers from a keg and places them onto the table, keeping it refreshed. To the SOUTH, there is a long line outside of the bathroom. There are also doors to the NORTH and WEST.

>go north
Dining Room
A dining room that has been converted to a sort of beer pong arena. Teams are playing the game at four different tables, which take up the majority of the room. There is an air of intensity from how seriously the players are taking their game. There are doors to the SOUTH and WEST.

>go west
Patio
An open-aired social area with many chairs and tables. People are sitting about, smoking cigarettes. You see a pledge with a sign around his neck that says, "Pack of Smokes: $5". Stairs down into the main area of the backyard are to the NORTH. There are doors to the EAST and SOUTH.

You can see Cigarette Bitch here.

>ask cigarette bitch about smokes
He's a pledge, what's he gonna know?

* * *

>go west
Patio
An open-aired social area with many chairs and tables. People are sitting about, smoking cigarettes. You see a pledge with a sign around his neck that says, "Pack of Smokes: $5". Stairs down into the main area of the backyard are to the NORTH. There are doors to the EAST and SOUTH.

You can see Cigarette Bitch here.

>ask bitch about pack of smokes
The Pledge is happy to see a friendly face for once, "Don't worry about these ok?" he says as he slips you a pack for free.

He's a pledge, what's he gonna know?

>ask bitch about pack of smokes
The Pledge likes you, but not enough to get caught giving away free smokes. Enjoy the pack you already have.

He's a pledge, what's he gonna know?

>i
You are carrying:
  a Pack of Smokes
    twelve cigarettes
  a beer

* * *

>go north
Dining Room
A dining room that has been converted to a sort of beer pong arena. Teams are playing the game at four different tables, which take up the majority of the room. There is an air of intensity from how seriously the players are taking their game. There are doors to the SOUTH and WEST.

>go north
You can't go that way.

>go west
Patio
An open-aired social area with many chairs and tables. People are sitting about, smoking cigarettes. You see a pledge with a sign around his neck that says, "Pack of Smokes: $5". Stairs down into the main area of the backyard are to the NORTH. There are doors to the EAST and SOUTH.

You can see Cigarette Bitch here.

>ask bitch about pack of smokes
The Pledge is happy to see a friendly face for once, "Don't worry about these ok?" he says as he slips you a pack for free.

* * *

>go east
Kitchen
A Kitchen. There are several fridges, an oven range, as well as a table. On the table, there are full cups of beer. A pair of pledges pours beers from a keg and places them onto the table, keeping it refreshed. To the SOUTH, there is a long line outside of the bathroom. There are also doors to the NORTH and WEST.

>go west
Entrance Hall
People are scattered about in conversation, drinking beer. You can see pledges rushing to and fro, balancing cups of beer and packed bongs. There are doors to the EAST and WEST, as well as stairs to the NORTH. The exit back to the porch is SOUTH.

>go east
Kitchen
A Kitchen. There are several fridges, an oven range, as well as a table. On the table, there are full cups of beer. A pair of pledges pours beers from a keg and places them onto the table, keeping it refreshed. To the SOUTH, there is a long line outside of the bathroom. There are also doors to the NORTH and WEST.

* * *

>go west
Patio
An open-aired social area with many chairs and tables. People are sitting about, smoking cigarettes. You see a pledge with a sign around his neck that says, "Pack of Smokes: $5". Stairs down into the main area of the backyard are to the NORTH. There are doors to the EAST and SOUTH.

You can see Cigarette Bitch here.

>ask bitch about smokes
He's a pledge, what's he gonna know?

>ask Cigarette Bitch about Pack of Smokes
"Cigarette's are 5 bucks."

* * *

>go west
Entrance Hall
People are scattered about in conversation, drinking beer. You can see pledges rushing to and fro, balancing cups of beer and packed bongs. There are doors to the EAST and WEST, as well as stairs to the NORTH. The exit back to the porch is SOUTH.

>go north
Central Hallway
A long hallway, in several parts. You can explore more of the hallway by going EAST and WEST. To the SOUTH are the stairs back to the Entrance Hall. In this part of the Hallway, there is a door to the NORTH.

>go north
Designated Hookup Room
The first thing you notice upon entering this room is the couple having sex on the bed to your right. There are three beds, evenly spaced out. In one corner of the room, there is a pile of sheets to put on the bed. In the other corner, there is a pile of condoms. The exit is to the SOUTH.

>go south
Central Hallway
A long hallway, in several parts. You can explore more of the hallway by going EAST and WEST. To the SOUTH are the stairs back to the Entrance Hall. In this part of the Hallway, there is a door to the NORTH.

* * *

>go east
East Hallway
The east part of the hallway. There are doors to the NORTH, EAST, and SOUTH.

>go west
Central Hallway
A long hallway, in several parts. You can explore more of the hallway by going EAST and WEST. To the SOUTH are the stairs back to the Entrance Hall. In this part of the Hallway, there is a door to the NORTH.

>go south
Entrance Hall
People are scattered about in conversation, drinking beer. You can see pledges rushing to and fro, balancing cups of beer and packed bongs. There are doors to the EAST and WEST, as well as stairs to the NORTH. The exit back to the porch is SOUTH.

>go east
Kitchen
A Kitchen. There are several fridges, an oven range, as well as a table. On the table, there are full cups of beer. A pair of pledges pours beers from a keg and places them onto the table, keeping it refreshed. To the SOUTH, there is a long line outside of the bathroom. There are also doors to the NORTH and WEST.